E E E E E E E E E E E E E E E E E E E E E E E E E E E E E E E E
E A A A A A A A A A A A F F F E W W W W W W W W A A A A A A 5 E
E 0 A A A A A A A A A 3 F F 1 E W W W W W W W W E A A A A A A E
E E E A E A E E E E A E E E E E W W E E E E E W E A A A E E E E
E A A A A A A A A A A W W W W W W E 2 W W W W W E A A A A A 4 E
E E E E E E E E E E E E E E E E E E E E E E E E E E E E E E E E